# mime_types.txt
#
# A list of file extensions followed by the corresponding MIME type.
# Extensions not found in the table are returned as text/plain.

html	text/html; charset=%s
htm	text/html; charset=%s
txt	text/plain; charset=%s
rtx	text/richtext
etx	text/x-setext
tsv	text/tab-separated-values
css	text/css
xml	text/xml
dtd	text/xml

gif	image/gif
jpg	image/jpeg
jpeg	image/jpeg
jpe	image/jpeg
jfif	image/jpeg
tif	image/tiff
tiff	image/tiff
pbm	image/x-portable-bitmap
pgm	image/x-portable-graymap
ppm	image/x-portable-pixmap
pnm	image/x-portable-anymap
xbm	image/x-xbitmap
xpm	image/x-xpixmap
xwd	image/x-xwindowdump
ief	image/ief
png	image/png

au	audio/basic
snd	audio/basic
aif	audio/x-aiff
aiff	audio/x-aiff
aifc	audio/x-aiff
ra	audio/x-pn-realaudio
ram	audio/x-pn-realaudio
rm	audio/x-pn-realaudio
rpm	audio/x-pn-realaudio-plugin
wav	audio/wav
mid	audio/midi
midi	audio/midi
kar	audio/midi
mpga	audio/mpeg
mp2	audio/mpeg
mp3	audio/mpeg

mpeg	video/mpeg
mpg	video/mpeg
mpe	video/mpeg
qt	video/quicktime
mov	video/quicktime
avi	video/x-msvideo
movie	video/x-sgi-movie
mv	video/x-sgi-movie
vx	video/x-rad-screenplay

a	application/octet-stream
bin	application/octet-stream
exe	application/octet-stream
dump	application/octet-stream
o	application/octet-stream
csv	application/octet-stream
class	application/java
js	application/x-javascript
ai	application/postscript
eps	application/postscript
ps	application/postscript
dir	application/x-director
dcr	application/x-director
dxr	application/x-director
fgd	application/x-director
aam	application/x-authorware-map
aas	application/x-authorware-seg
aab	application/x-authorware-bin
fh4	image/x-freehand
fh7	image/x-freehand
fh5	image/x-freehand
fhc	image/x-freehand
fh	image/x-freehand
spl	application/futuresplash
swf	application/x-shockwave-flash
dvi	application/x-dvi
gtar	application/x-gtar
hdf	application/x-hdf
hqx	application/mac-binhex40
iv	application/x-inventor
latex	application/x-latex
man	application/x-troff-man
me	application/x-troff-me
mif	application/x-mif
ms	application/x-troff-ms
oda	application/oda
pdf	application/pdf
rtf	application/rtf
bcpio	application/x-bcpio
cpio	application/x-cpio
sv4cpio	application/x-sv4cpio
sv4crc	application/x-sv4crc
sh	application/x-shar
shar	application/x-shar
sit	application/x-stuffit
tar	application/x-tar
tex	application/x-tex
texi	application/x-texinfo
texinfo	application/x-texinfo
tr	application/x-troff
roff	application/x-troff
zip	application/x-zip-compressed
tsp	application/dsptype
wsrc	application/x-wais-source
ustar	application/x-ustar
cdf	application/x-netcdf
nc	application/x-netcdf
doc	application/msword
dot	application/msword
ppt	application/powerpoint

wrl	model/vrml
vrml	model/vrml
mime	message/rfc822

pac	application/x-ns-proxy-autoconfig

wml	text/vnd.wap.wml
wmlc	application/vnd.wap.wmlc
wmls	text/vnd.wap.wmlscript
wmlsc	application/vnd.wap.wmlscriptc
wbmp	image/vnd.wap.wbmp

dotx	application/vnd.openxmlformats-officedocument.wordprocessingml.template
docx	application/vnd.openxmlformats-officedocument.wordprocessingml.document
potx	application/vnd.openxmlformats-officedocument.presentationml.template
pptx	application/vnd.openxmlformats-officedocument.presentationml.presentation
ppsx	application/vnd.openxmlformats-officedocument.presentationml.slideshow
xltx	application/vnd.openxmlformats-officedocument.spreadsheetml.template
xlsx	application/vnd.openxmlformats-officedocument.spreadsheetml.sheet
sldx	application/vnd.openxmlformats-officedocument.presentationml.slide

323	text/h323
atom	application/atom+xml
x	application/directx
evy	application/envoy
fif	application/fractals
hta	application/hta
acx	application/internet-property-stream
jar	application/java-archive
jck	application/liquidmotion
jcz	application/liquidmotion
accdb	application/msaccess
accde	application/msaccess
accdt	application/msaccess
aaf	application/octet-stream
aca	application/octet-stream
afm	application/octet-stream
asd	application/octet-stream
asi	application/octet-stream
cab	application/octet-stream
chm	application/octet-stream
cur	application/octet-stream
dsp	application/octet-stream
dwp	application/octet-stream
emz	application/octet-stream
eot	application/octet-stream
fla	application/octet-stream
hhk	application/octet-stream
hhp	application/octet-stream
ics	application/octet-stream
inf	application/octet-stream
java	application/octet-stream
jpb	application/octet-stream
lpk	application/octet-stream
lzh	application/octet-stream
mdp	application/octet-stream
mix	application/octet-stream
msi	application/octet-stream
mso	application/octet-stream
ocx	application/octet-stream
pcx	application/octet-stream
pcz	application/octet-stream
pfb	application/octet-stream
pfm	application/octet-stream
prm	application/octet-stream
prx	application/octet-stream
psd	application/octet-stream
psm	application/octet-stream
psp	application/octet-stream
qxd	application/octet-stream
rar	application/octet-stream
sea	application/octet-stream
smi	application/octet-stream
snp	application/octet-stream
thn	application/octet-stream
toc	application/octet-stream
ttf	application/octet-stream
u32	application/octet-stream
xsn	application/octet-stream
xtp	application/octet-stream
ods	application/oleobject
axs	application/olescript
one	application/onenote
onea	application/onenote
onepkg	application/onenote
onetmp	application/onenote
onetoc	application/onenote
onetoc2	application/onenote
prf	application/pics-rules
p10	application/pkcs10
p7c	application/pkcs7-mime
p7m	application/pkcs7-mime
p7s	application/pkcs7-signature
crl	application/pkix-crl
setpay	application/set-payment-initiation
setreg	application/set-registration-initiation
ssm	application/streamingmedia
fdf	application/vndfdf
xla	application/vndms-excel
xlc	application/vndms-excel
xlm	application/vndms-excel
xls	application/vndms-excel
xlt	application/vndms-excel
xlw	application/vndms-excel
xlam	application/vndms-exceladdinmacroEnabled12
xlsb	application/vndms-excelsheetbinarymacroEnabled12
xlsm	application/vndms-excelsheetmacroEnabled12
xltm	application/vndms-exceltemplatemacroEnabled12
thmx	application/vndms-officetheme
sst	application/vndms-pkicertstore
pko	application/vndms-pkipko
cat	application/vndms-pkiseccat
stl	application/vndms-pkistl
pot	application/vndms-powerpoint
ppam	application/vndms-powerpointaddinmacroEnabled12
pptm	application/vndms-powerpointpresentationmacroEnabled12
sldm	application/vndms-powerpointslidemacroEnabled12
ppsm	application/vndms-powerpointslideshowmacroEnabled12
potm	application/vndms-powerpointtemplatemacroEnabled12
pps	application/vndms-pps
mpp	application/vndms-project
vdx	application/vndms-visioviewer
docm	application/vndms-worddocumentmacroEnabled12
dotm	application/vndms-wordtemplatemacroEnabled12
wcm	application/vndms-works
wdb	application/vndms-works
wks	application/vndms-works
wps	application/vndms-works
vsd	application/vndvisio
vss	application/vndvisio
vst	application/vndvisio
vsw	application/vndvisio
vsx	application/vndvisio
vtx	application/vndvisio
hlp	application/winhlp
z	application/x-compress
tgz	application/x-compressed
csh	application/x-csh
gz	application/x-gzip
ins	application/x-internet-signup
isp	application/x-internet-signup
iii	application/x-iphone
mvc	application/x-miva-compiled
mdb	application/x-msaccess
crd	application/x-mscardfile
clp	application/x-msclip
dll	application/x-msdownload
m13	application/x-msmediaview
m14	application/x-msmediaview
mvb	application/x-msmediaview
wmf	application/x-msmetafile
mny	application/x-msmoney 
pub	application/x-mspublisher
lit	application/x-ms-reader
scd	application/x-msschedule
trm	application/x-msterminal
wmd	application/x-ms-wmd
wmz	application/x-ms-wmz
wri	application/x-mswrite
hhc	application/x-oleobject
pma	application/x-perfmon
pmc	application/x-perfmon
pml	application/x-perfmon
pmr	application/x-perfmon
pmw	application/x-perfmon
p12	application/x-pkcs12
pfx	application/x-pkcs12
p7b	application/x-pkcs7-certificates
spc	application/x-pkcs7-certificates
p7r	application/x-pkcs7-certreqresp
qtl	application/x-quicktimeplayer
mmf	application/x-smaf 
tcl	application/x-tcl
t	application/x-troff
src	application/x-wais-source
crt	application/x-x509-ca-cert
der	application/x-x509-ca-cert
rmi	audio/mid
m3u	audio/x-mpegurl
wax	audio/x-ms-wax
wma	audio/x-ms-wma
smd	audio/x-smd
smx	audio/x-smd
smz	audio/x-smd
dwf	drawing/x-dwf
bmp	image/bmp
dib	image/bmp
cod	image/cis-cod
pnz	image/png
rf	image/vndrn-realflash
ras	image/x-cmu-raster
cmx	image/x-cmx
ico	image/x-icon
art	image/x-jg
rgb	image/x-rgb
eml	message/rfc822
mht	message/rfc822
mhtml	message/rfc822
nws	message/rfc822
dlm	text/dlm
hxt	text/html
uls	text/iuls
asm	text/plain
bas	text/plain
c	text/plain
cnf	text/plain
cpp	text/plain
h	text/plain
map	text/plain
vcs	text/plain
xdr	text/plain
sct	text/scriptlet
sgml	text/sgml
vbs	text/vbscript
htt	text/webviewhtml
htc	text/x-component
hdml	text/x-hdml
disco	text/xml
mno	text/xml
vml	text/xml
wsdl	text/xml
xsd	text/xml
xsf	text/xml
xsl	text/xml
xslt	text/xml
vcf	text/x-vcard
m1v	video/mpeg
mpa	video/mpeg
mpv2	video/mpeg
IVF	video/x-ivf
lsf	video/x-la-asf
lsx	video/x-la-asf
asf	video/x-ms-asf
asr	video/x-ms-asf
asx	video/x-ms-asf
nsc	video/x-ms-asf
wm	video/x-ms-wm
wmp	video/x-ms-wmp
wmv	video/x-ms-wmv
wmx	video/x-ms-wmx
wvx	video/x-ms-wvx
flr	x-world/x-vrml
xaf	x-world/x-vrml
xof	x-world/x-vrml
wrz	x-world/x-vrml 
mib	application/force-download
svg	image/svg+xml
svgz	image/svg+xml
